8 11
***********
*S*000*000*
*0*0*0*E*0*
*0***0***0*
*00000*000*
*0***0*0*0*
*0*00000*0*
***********

